static const bettySvg = 'assets/icon/betty.svg';
static const bettylogoTextWhiteSvg = 'assets/icon/bettylogo-text-white.svg';
static const icAddSquareBulkSvg = 'assets/icon/ic-add-square-bulk.svg';
static const icAddSquareSvg = 'assets/icon/ic-add-square.svg';
static const icAddSquareActiveSvg = 'assets/icon/ic-add-square_active.svg';
static const icAddSvg = 'assets/icon/ic-add.svg';
static const icAmicoSvg = 'assets/icon/ic-amico.svg';
static const icArchiveBookFilledSvg = 'assets/icon/ic-archive-book-filled.svg';
static const icArchiveTickSvg = 'assets/icon/ic-archive-tick.svg';
static const icArrowCircleRightSvg = 'assets/icon/ic-arrow-circle-right.svg';
static const icArrowDownSvg = 'assets/icon/ic-arrow-down.svg';
static const icArrowKeyboardSvg = 'assets/icon/ic-arrow-keyboard.svg';
static const icArrowLeftSvg = 'assets/icon/ic-arrow-left.svg';
static const icArrowRightSvg = 'assets/icon/ic-arrow-right.svg';
static const icArrowRight2Svg = 'assets/icon/ic-arrow-right2.svg';
static const icArrowSortSvg = 'assets/icon/ic-arrow-sort.svg';
static const icArrowSquareDownSvg = 'assets/icon/ic-arrow-square-down.svg';
static const icArrowUpSvg = 'assets/icon/ic-arrow-up.svg';
static const icArrowSvg = 'assets/icon/ic-arrow.svg';
static const icAttachmentSvg = 'assets/icon/ic-attachment.svg';
static const icAvgOrderPriceSvg = 'assets/icon/ic-avg-order-price.svg';
static const icBackspaceSvg = 'assets/icon/ic-backspace.svg';
static const icBackupSvg = 'assets/icon/ic-backup.svg';
static const icBluetoothFilledSvg = 'assets/icon/ic-bluetooth-filled.svg';
static const icBluetoothWithbgSvg = 'assets/icon/ic-bluetooth-withbg.svg';
static const icBluetoothSvg = 'assets/icon/ic-bluetooth.svg';
static const icBoxAddSvg = 'assets/icon/ic-box-add.svg';
static const icBoxTickActiveSvg = 'assets/icon/ic-box-tick-active.svg';
static const icBoxTickSvg = 'assets/icon/ic-box-tick.svg';
static const icBoxTimeSvg = 'assets/icon/ic-box-time.svg';
static const icBoxSvg = 'assets/icon/ic-box.svg';
static const icCallCallingSvg = 'assets/icon/ic-call-calling.svg';
static const icCameraSvg = 'assets/icon/ic-camera.svg';
static const icCardFilledSvg = 'assets/icon/ic-card-filled.svg';
static const icCashSvg = 'assets/icon/ic-cash.svg';
static const icCategoryActiveSvg = 'assets/icon/ic-category-active.svg';
static const icCategorySvg = 'assets/icon/ic-category.svg';
static const icChartSquareActiveSvg = 'assets/icon/ic-chart-square-active.svg';
static const icChartSquareSvg = 'assets/icon/ic-chart-square.svg';
static const icCheckSvg = 'assets/icon/ic-check.svg';
static const icChecklistSvg = 'assets/icon/ic-checklist.svg';
static const icChooseImageSvg = 'assets/icon/ic-choose-image.svg';
static const icCleartextfieldSvg = 'assets/icon/ic-cleartextfield.svg';
static const icClipboardTickActiveSvg = 'assets/icon/ic-clipboard-tick-active.svg';
static const icClipboardTickSvg = 'assets/icon/ic-clipboard-tick.svg';
static const icCloseCircleSvg = 'assets/icon/ic-close-circle.svg';
static const icCloseRoundedSvg = 'assets/icon/ic-close-rounded.svg';
static const icCloseSvg = 'assets/icon/ic-close.svg';
static const icDangerRedbgSvg = 'assets/icon/ic-danger-redbg.svg';
static const icDebitccSvg = 'assets/icon/ic-debitcc.svg';
static const icDeliveryActiveSvg = 'assets/icon/ic-delivery-active.svg';
static const icDeliverySvg = 'assets/icon/ic-delivery.svg';
static const icDocumentDownloadSvg = 'assets/icon/ic-document-download.svg';
static const icDocumentExportSvg = 'assets/icon/ic-document-export.svg';
static const icDocumentUploadSvg = 'assets/icon/ic-document-upload.svg';
static const icDocumentSvg = 'assets/icon/ic-document.svg';
static const icEditBlackSvg = 'assets/icon/ic-edit-black.svg';
static const icEditSvg = 'assets/icon/ic-edit.svg';
static const icEmptySvg = 'assets/icon/ic-empty.svg';
static const icExcelSvg = 'assets/icon/ic-excel.svg';
static const icExpandSvg = 'assets/icon/ic-expand.svg';
static const icExportReportExcelSvg = 'assets/icon/ic-export-report-excel.svg';
static const icExportReportPdfSvg = 'assets/icon/ic-export-report-pdf.svg';
static const icExportReportSvg = 'assets/icon/ic-export-report.svg';
static const icEyeSlashSvg = 'assets/icon/ic-eye-slash.svg';
static const icEyeSvg = 'assets/icon/ic-eye.svg';
static const icFilterSortSvg = 'assets/icon/ic-filter-sort.svg';
static const icFilterSvg = 'assets/icon/ic-filter.svg';
static const icGalleryGreenSvg = 'assets/icon/ic-gallery-green.svg';
static const icGallerySvg = 'assets/icon/ic-gallery.svg';
static const icGoogleSvg = 'assets/icon/ic-google.svg';
static const icHomeSvg = 'assets/icon/ic-home.svg';
static const icInfoCircleBluebgSvg = 'assets/icon/ic-info-circle-bluebg.svg';
static const icInfoCircleRedSvg = 'assets/icon/ic-info-circle-red.svg';
static const icInfoCircleYellowbgSvg = 'assets/icon/ic-info-circle-yellowbg.svg';
static const icInfoCircleSvg = 'assets/icon/ic-info-circle.svg';
static const icInstoreActiveSvg = 'assets/icon/ic-instore-active.svg';
static const icInstoreSvg = 'assets/icon/ic-instore.svg';
static const icKeySvg = 'assets/icon/ic-key.svg';
static const icLanguageSquareFilledSvg = 'assets/icon/ic-language-square-filled.svg';
static const icLanguageSquareSvg = 'assets/icon/ic-language-square.svg';
static const icLocationWithbgSvg = 'assets/icon/ic-location-withbg.svg';
static const icLocationSvg = 'assets/icon/ic-location.svg';
static const icLoginSvg = 'assets/icon/ic-login.svg';
static const icLogoutSvg = 'assets/icon/ic-logout.svg';
static const icMapSvg = 'assets/icon/ic-map.svg';
static const icMaximizeSvg = 'assets/icon/ic-maximize.svg';
static const icMedalStarFilledSvg = 'assets/icon/ic-medal-star-filled.svg';
static const icMenuSvg = 'assets/icon/ic-menu.svg';
static const icMessages_3FilledSvg = 'assets/icon/ic-messages-3-filled.svg';
static const icMinSvg = 'assets/icon/ic-min.svg';
static const icMinusSquareBulkSvg = 'assets/icon/ic-minus-square-bulk.svg';
static const icMoneyReceiveSvg = 'assets/icon/ic-money-receive.svg';
static const icMotorSvg = 'assets/icon/ic-motor.svg';
static const icNoteActiveSvg = 'assets/icon/ic-note-active.svg';
static const icNoteAddSvg = 'assets/icon/ic-note-add.svg';
static const icNoteSvg = 'assets/icon/ic-note.svg';
static const icNotificationSvg = 'assets/icon/ic-notification.svg';
static const icPdfSvg = 'assets/icon/ic-pdf.svg';
static const icPresentionChartSvg = 'assets/icon/ic-presention-chart.svg';
static const icPrinterSvg = 'assets/icon/ic-printer.svg';
static const icProductActiveSvg = 'assets/icon/ic-product-active.svg';
static const icProductSvg = 'assets/icon/ic-product.svg';
static const icProfileFilledSvg = 'assets/icon/ic-profile-filled.svg';
static const icProfileSvg = 'assets/icon/ic-profile.svg';
static const icQrisSvg = 'assets/icon/ic-qris.svg';
static const icQuestionMarkActiveSvg = 'assets/icon/ic-question-mark-active.svg';
static const icQuestionMarkSvg = 'assets/icon/ic-question-mark.svg';
static const icRefreshSquare_2Svg = 'assets/icon/ic-refresh-square-2.svg';
static const icRefreshSvg = 'assets/icon/ic-refresh.svg';
static const icRemovePaymentSvg = 'assets/icon/ic-remove-payment.svg';
static const icReserveOrangeSvg = 'assets/icon/ic-reserve-orange.svg';
static const icReserveSvg = 'assets/icon/ic-reserve.svg';
static const icReserve2Svg = 'assets/icon/ic-reserve2.svg';
static const icRestoreDoneSvg = 'assets/icon/ic-restore-done.svg';
static const icRotateRightSvg = 'assets/icon/ic-rotate-right.svg';
static const icRoutingSvg = 'assets/icon/ic-routing.svg';
static const icSalesOfItemSvg = 'assets/icon/ic-sales-of-item.svg';
static const icSearchNormalSvg = 'assets/icon/ic-search-normal.svg';
static const icSearchNotffoundSvg = 'assets/icon/ic-search-notffound.svg';
static const icSetting_2Svg = 'assets/icon/ic-setting-2.svg';
static const icSettingSvg = 'assets/icon/ic-setting.svg';
static const icShareSvg = 'assets/icon/ic-share.svg';
static const icShieldFilledSvg = 'assets/icon/ic-shield-filled.svg';
static const icShieldSearchSvg = 'assets/icon/ic-shield-search.svg';
static const icShieldTickFilledSvg = 'assets/icon/ic-shield-tick-filled.svg';
static const icShieldTickSvg = 'assets/icon/ic-shield-tick.svg';
static const icShopFilledSvg = 'assets/icon/ic-shop-filled.svg';
static const icShopWithbgSvg = 'assets/icon/ic-shop-withbg.svg';
static const icShopSvg = 'assets/icon/ic-shop.svg';
static const icShoppingSvg = 'assets/icon/ic-shopping.svg';
static const icSmsWithbgSvg = 'assets/icon/ic-sms-withbg.svg';
static const icSmsSvg = 'assets/icon/ic-sms.svg';
static const icStarNewFilledSvg = 'assets/icon/ic-star-new-filled.svg';
static const icStarNewHoverSvg = 'assets/icon/ic-star-new-hover.svg';
static const icStarNewSvg = 'assets/icon/ic-star-new.svg';
static const icStarSvg = 'assets/icon/ic-star.svg';
static const icStatusSvg = 'assets/icon/ic-status.svg';
static const icStorageSvg = 'assets/icon/ic-storage.svg';
static const icTablewareSvg = 'assets/icon/ic-tableware.svg';
static const icTickCircleGreySvg = 'assets/icon/ic-tick-circle-grey.svg';
static const icTickCircleSuccessSvg = 'assets/icon/ic-tick-circle-success.svg';
static const icTickCircleSvg = 'assets/icon/ic-tick-circle.svg';
static const icToggleOffSvg = 'assets/icon/ic-toggle-off.svg';
static const icToggleOnSvg = 'assets/icon/ic-toggle-on.svg';
static const icToogleSvg = 'assets/icon/ic-toogle.svg';
static const icTotalIncomeSvg = 'assets/icon/ic-total-income.svg';
static const icTransactionMinusActiveSvg = 'assets/icon/ic-transaction-minus-active.svg';
static const icTransactionMinusSvg = 'assets/icon/ic-transaction-minus.svg';
static const icTrashSvg = 'assets/icon/ic-trash.svg';
static const icUpdateSvg = 'assets/icon/ic-update.svg';
static const icUserAddSvg = 'assets/icon/ic-user-add.svg';
static const icUserTagSvg = 'assets/icon/ic-user-tag.svg';
static const icVerifyWithbgSvg = 'assets/icon/ic-verify-withbg.svg';
static const icVerifySvg = 'assets/icon/ic-verify.svg';
static const icWalletFilledSvg = 'assets/icon/ic-wallet-filled.svg';
static const icWalletTimerSvg = 'assets/icon/ic-wallet-timer.svg';
static const icWarningHexagonSvg = 'assets/icon/ic-warning-hexagon.svg';
static const icWarningSvg = 'assets/icon/ic-warning.svg';
static const starSvg = 'assets/icon/star.svg';
